|-----------------------------------------------------------------------------|
|.............................................................................|
|.............................................................................|
|.............................................................................|
|...|---------------------------------+-----------------------------------|...|
|...|                                 #                                   |...|
|...| |----------| |--------------| |-+----------------| |--------------| |...|
|...| |..........| |..............| |..................| |..............| |...|
|...| |..........| |..............| |..................| |..............| |...|
|...| |..........| |..............| |..................| |..............| |...|
|...| |..........| |..............| |..................| |..............| |...|
|...| |..........| |..............| |..................| |..............| |...|
|...| |..........| |..............| |..................| |..............| |...|
|...+#+..........| |..............| |..................| |..............+#+...|
|...| |..........| |..............| |..................| |..............| |...|
|...| |..........| |..............| |..................| |..............| |...|
|...| |..........| |..............| |..................| |..............| |...|
|...| |..........| |..............| |..................| |..............| |...|
|...| |----------| |------+-------| |------------------| |--------------| |...|
|...|                     #############                                   |...|
|...|---------------------------------+-----------------------------------|...|
|.............................................................................|
|.............................................................................|
|.............................................................................|
|-----------------------------------------------------------------------------|
