|-----------------------------------------------------------------------------|
|.............................................................................|
|.............................................................................|
|.............................................................................|
|...|---------------------------------+-----------------------------------|...|
|...|                                                                     |...|
|...| |----------| |--------------| |------------------|-|--------------| |...|
|...| |..........| |..............| |..................|.|..............| |...|
|...| |..........| |..............| |..................|.|..............| |...|
|...| |..........| |..............| |..................|.|..............| |...|
|...| |..........| |..............| |..................|.|..............| |...|
|...| |..........| |..............| |..................|.|..............| |...|
|...| |..........| |..............| |..................|.|..............| |...|
|...+#+..........| |..............| |..................|.|..............| +...|
|...| |..........| |..............| |------------------|-|..............| |...|
|...| |..........| |..............| |........          | |           #  | |...|
|...| |..........| |..............|-|-----------|      | |           #  | |...|
|...| |..........| |..............|.|........          | |           #  | |...|
|...| |----------| |--------------|.|------------------| |--------------| |...|
|...|                                                                     |...|
|...|---------------------------------+-----------------------------------|...|
|.............................................................................|
|.............................................................................|
|.............................................................................|
|-----------------------------------------------------------------------------|
