|-----------------------------------------------------------------------------|
|                     |---------------------------------------|  |----------| |
|   |---------------| |.......................................|  |..........| |
|   |...............| |.......................................|  |..........| |
|   |...............| |----+-------------------------|........|  |..........| |
|   |...............|      #      |-------------|    |........+##+..........| |
|   |...............|      #      |.............|    |........|  |..........| |
|   |...............|------+------|.............|    |........|  |..........| |
|   |...........................................+####+........|  |..........| |
|   |...........................................|    |........|  |..........| |
|   |...........................................|    |........|  |..........| |
|   |-------------------------------------------|    |--------|  |..........| |
|                                                                |..........| |
|   |-------------------------------------|  |-------------------|..........| |
|   |.....................................|  |..............................| |
|   |.....................................|  |..............................| |
|   |.....................................|  |..............................| |
|   |.....................................|  |------+-----------------------| |
|   |.....................................|         #       |--------------|  |
|   |.....................................|---------+-----| |..............|  |
|   |.....................................................| |..............|  |
|   |.....................................................+#+..............|  |
|   |-----------------------------------------------------| |..............|  |
|                                                           |--------------|  |
|-----------------------------------------------------------------------------|
