|-----------------------------------------------------------------------------|
|                     |---------------------------------------|  |----------| |
|                     |.......................................|  |..........| |
|                     |.......................................|  |..........| |
|                     |.......................................|  |..........| |
|                     |.......................................+##+..........| |
|                     |..........................|------------|  |..........| |
|                     |..........................|               |..........| |
|                     |..........................|------------|  |..........| |
|                  ###+.......................................|  |..........| |
|                  #  |.......................................|  |..........| |
|                  #  |------------------------------|........|  |..........| |
|                  #                                 |........|  |..........| |
|   |--------------+-------|  |-----------|          |--------|  |..........| |
|   |......................|  |...........|                      |---+------| |
|   |......................|  |...........|                          #        |
|   |......................|  |...........|                          #        |
|   |......................+##+...........|                          #        |
|   |......................|  |...........|                 |--------+-----|  |
|   |......................|  |...........|---------------| |..............|  |
|   |......................|  |...........................| |..............|  |
|   |......................|  |...........................+#+..............|  |
|   |----------------------|  |---------------------------| |..............|  |
|                                                           |--------------|  |
|-----------------------------------------------------------------------------|
