|---------------|                          |---------------|                   
|...............|                          |...............|                   
|...............|                          |...............|                   
|...............+##########################+...............|                   
|...............|            #             |...............|                   
|...............|            #             |...............|                   
|---------------|            #             |---------------|                   
                             #                                                 
                             #                                                 
|----------------------------+------------------------------------------------|
|.............................................................................|
|.............................................................................|
|.............................................................................|
|.............................................................................|
|.............................................................................|
|.............................................................................|
|--------------------------------------+--------------------------------------|
                                       #                                       
|---------------|                      #   |---------------|                   
|...............|                      #   |...............|                   
|...............|                      #   |...............|                   
|...............+##########################+...............|                   
|...............|                          |...............|                   
|...............|                          |...............|                    
|---------------|                          |---------------|                   
