|-----------------------------------------------------------------------------|
|                     |---------------------------------------|  |----------| |
|   |---------------| |.......................................|  |..........| |
|   |...............| |.......................................|  |..........| |
|   |...............| |----+-------------------------|........|  |..........| |
|   |...............|      #      |-------------|    |........+##+..........| |
|   |...............|      #      |.............|    |........|  |..........| |
|   |...............|------+------|.............|    |........|  |..........| |
|   |...........................................+####+........|  |..........| |
|   |...........................................|    |........|  |..........| |
|   |...........................................|    |........|  |..........| |
|   |----------|.......|------------------------|    |--------|  |..........| |
|              |.......|                                         |..........| |
|   |----------|.......|---|  |-----------|  |-------------------|..........| |
|   |......................|  |...........|  |..............................| |
|   |......................|  |...........|  |..............................| |
|   |......................|  |...........|  |..............................| |
|   |......................|  |...........|  |------+-----------------------| |
|   |......................|  |...........|         #       |--------------|  |
|   |......................|  |...........|---------+-----| |..............|  |
|   |......................|  |...........................| |..............|  |
|   |......................|  |...........................+#+..............|  |
|   |----------------------|  |---------------------------| |..............|  |
|                                                           |--------------|  |
|-----------------------------------------------------------------------------|
