|-----------------------------------------------------------------------------|
|                     |---------------------------------------|  |----------| |
|   |---------------| |.......................................|  |..........| |
|   |...............| |.......................................|  |..........| |
|   |...............| |----+-------------------------|........|  |..........| |
|   |...............|      #      |-------------|    |........+##+..........| |
|   |...............|      #      |.............|    |--------|  |..........| |
|   |...............|------+------|.............|                |..........| |
|   |...........................................|    |--------|  |..........| |
|   |...........................................|    |........|  |..........| |
|   |...........................................|    |........|  |..........| |
|   |----------|.......|-----------+------------|    |........|  |..........| |
|              |.......|           #                 |........|  |..........| |
|   |----------|.......|---|  |----+------|  |-------|........|--|..........| |
|   |......................|  |...........|  |..............................| |
|   |......................|  |...........|  |..............................| |
|   |......................|  |...........|  |..............................| |
|   |......................|  |...........|  |------------------------------| |
|   |......................|  |...........|                 |--------------|  |
|   |......................|  |...........|---------------| |..............|  |
|   |......................|  |...........................| |..............|  |
|   |......................|  |...........................+#+..............|  |
|   |----------------------|  |---------------------------| |..............|  |
|                                                           |--------------|  |
|-----------------------------------------------------------------------------|
