|-----------------------------------------------------------------------------|
|.............................................................................|
|.............................................................................|
|.............................................................................|
|...|------+--------------+-----------+----------------------+------------|...|
|...|      #              #           #                      #            |...|
|...| |----+-----| |------+-------| |-+----------------| |---+----------| |...|
|...| |..........+#+..............+#+..................+#+..............| |...|
|...| |..........| |..............| |..................| |..............| |...|
|...| |..........| |..............| |..................| |..............| |...|
|...| |..........| |..............| |..................| |..............| |...|
|...| |..........| |..............| |..................| |..............| |...|
|...| |..........| |..............| |..................| |..............| |...|
|...+#+..........| |..............| |..................| |..............+#+...|
|...| |..........| |..............| |..................| |..............| |...|
|...| |..........| |..............| |..................| |..............| |...|
|...| |..........| |..............| |..................| |..............| |...|
|...| |..........| |..............| |..................| |..............| |...|
|...| |----+-----| |------+-------| |-----------+------| |-----+--------| |...|
|...|      #              #############         #              #          |...|
|...|------+--------------------------+---------+--------------+----------|...|
|.............................................................................|
|.............................................................................|
|.............................................................................|
|-----------------------------------------------------------------------------|
