|-----------------------------------------------------------------------------|
|                     |---------------------------------------|  |----------| |
|   |---------------| |.......................................|  |..........| |
|   |...............| |.......................................|  |..........| |
|   |...............| |----+-------------------------|........|  |..........| |
|   |...............|      #      |-------------|    |........+##+..........| |
|   |...............|      #      |.............|    |........|  |..........| |
|   |...............|------+------|.............|    |........|  |..........| |
|   |...........................................|    |........|  |..........| |
|   |...........................................|    |........|  |..........| |
|   |...........................................|    |........|  |..........| |
|   |----------|.......|------------------------|    |--------|  |..........| |
|              |.......|     ################                    |..........| |
|   |----------|.......|---| #|-----------| #|-------------------|..........| |
|   |......................| #|...........| #|..............................| |
|   |......................| #|...........+##|..............................| |
|   |......................| #|...........|  |..............................| |
|   |......................| #|...........|  |------+-----------------------| |
|   |......................| #|...........|         #       |--------------|  |
|   |......................| #|...........|---------+-----| |..............|  |
|   |......................|##|...........................| |..............|  |
|  #+......................|# |...........................+#+..............|  |
|  #|----------------------|# |---------------------------|#|..............|  |
|  #########################################################|--------------|  |
|-----------------------------------------------------------------------------|
