|-----------------------------------------------------------------------------|
|................................|        |...................................|
|................................|        |...................................|
|................................+########+...................................|
|................................|        |...................................|
|................................|        |...................................|
|................|---------------------------------------|....................|
|................| |...................................| |....................|
|................| |...................................| |....................|
|................| |...................................| |....................|
|................| |...................................| |....................|
|-------+--------| |...................................| |------------+-------|
|       #          |...................................|              #       |
|       #          |...................................|              #       |
|-------+--------| |...................................| |------------+-------|
|................| |...................................| |....................|
|................| |...................................| |....................|
|................|-----------------+----+----------------|....................|
|................................| #    # |...................................|
|................................+##    ##+...................................|
|................................|        |...................................|
|................................|        |...................................|
|................................|        |...................................|
|................................|        |...................................|
|-----------------------------------------------------------------------------|
