|-----------------------------------------------------------------------------|
|.............................................................|...........|...|
|.............................................................+...........|...|
|.............................................................|...........|...|
|.............................................................|.......|...|...|
|.............................................................|.......|...|...|
|.......................|-------------------------------------|.......|.......|
|.......................|.....................................|.......|.......|
|.......................|.....................................+.......|.......|
|------+-----------+----|.....................................|.......|-------|
|.......................|.....................................|...............|
|.......................|.....................................|...............|
|.......................|.....................................|...............|
|.......................|.....................................|...............|
|.......................|.....................................|--+------+-----|
|.......................|...........................................|.........|
|.......................|...........................................|.........|
|.......................|-------------------------------------------|.........|
|....................................|........................................|
|....................................+........................................|
|....................................|........................................|
|....................................+........................................|
|....................................|........................................|
|....................................|........................................|
|-----------------------------------------------------------------------------|
