|-----------------------------------------------------------------------------|
|                                                             |           |   |
|                                                             |           |   |
|                                                             +           |   |
|                                                             |       |   |   |
|                                                             |       |   |   |
|                       |---+---------------------------------|       |       |
|                       |                                     |       |       |
|                       |                                     |       |       |
|-----------------------|                                     |       |-------|
|                       |                                     |               |
|                       |                                     |               |
|                       |                                     |               |
|                       |                                     |               |
|                       |                                     |---------------|
|                       |                                           |         |
|                       |                                           +         |
|                       |-------------------------------------------|         |
|                                    |                                        |
|                                    |                                        |
|                                    +                                        |
|                                    |                                        |
|                                    |                                        |
|                                    |                                        |
|-----------------------------------------------------------------------------|
