|-----------------------------------------------------------------------------|
|                           |..........................|                      |
|                           |..........................| |------------------| |
|                           |..........................| |..................| |
|                           |..........................| |..................| |
|                           |..........................| |..................| |
|                           |..........................| |..................| |
|                           |--------------------------| |..................| |
|                                                        |..................| |
|                           |--------------------------| |..................| |
|                           |..........................| |------------------| |
|                           |..........................|                      |
|                           |..........................|                      |
|  |--------------------|   |..........................|                      |
|  |....................|   |..........................|                      |
|  |....................|   |--------------------------|                      |
|  |....................|                                                     |
|  |....................|   |--------------------------|                      |
|  |....................|   |..........................|                      |
|  |....................|   |..........................|                      |
|  |....................|   |..........................|                      |
|  |....................|   |..........................|                      |
|  |--------------------|   |..........................|                      |
|                           |..........................|                      |
|-----------------------------------------------------------------------------|
