|-----------------------------------------------------------------------------|
|.............................................................|...........|...|
|.............................................................|...........|...|
|.............................................................+...........|...|
|.............................................................|.......|...|...|
|.............................................................|.......|...|...|
|.......................|-------------------------------------|.......|.......|
|.......................|.....................................|.......|.......|
|.......................|.....................................|.......|.......|
|-----------------------|.....................................|.......|-------|
|.......................|.....................................+...............|
|.......................|.....................................|...............|
|.......................|.....................................|...............|
|.......................|.....................................|...............|
|.......................|.....................................|---------------|
|.......................|...........................................|.........|
|.......................|...........................................|.........|
|.......................|--+----------------------------+-----------|.........|
|....................................|........................................|
|....................................|........................................|
|....................................|........................................|
|....................................|........................................|
|....................................|........................................|
|....................................|........................................|
|-----------------------------------------------------------------------------|
