|-----------------------------------------------------------------------------|
|                                                             |           |   |
|                                                             +           |   |
|                                                             |           |   |
|                                                             |       |   |   |
|                                                             |       |   |   |
|                       |-------------------------------------|       |       |
|                       |                                     |       |       |
|                       |                                     +       |       |
|------+-----------+----|                                     |       |-------|
|                       |                                     |               |
|                       |                                     |               |
|                       |                                     |               |
|                       |                                     |               |
|                       |                                     |--+------+-----|
|                       |                                           |         |
|                       |                                           |         |
|                       |-------------------------------------------|         |
|                                    |                                        |
|                                    +                                        |
|                                    |                                        |
|                                    +                                        |
|                                    |                                        |
|                                    |                                        |
|-----------------------------------------------------------------------------|
