|-----------------------------------------------------------------------------|
|...........................................|.................................|
|...........................................+.................................|
|...........................................|.................................|
|...........................................|.................................|
|...............................|-------------------------|...................|
|...............................| |.....................| |...................|
|...............................| |.....................| |...................|
|...............................+#+.....................+#+...................|
|...............................| |.....................| |...................|
|...............................| |.....|........|......| |...................|
|...............................| |.....|........|......| |...................|
|-------------------------------| |.....|........|......| |...................|
|...............................|-|.....|--------|......|-|-------------------|
|.................................|.....................|.....................|
|.................................|.....................+.....................|
|.................................|---+-----------------|.....................|
|.........................................|  |................................|
|.........................................|  |................................|
|.........................................|  |................................|
|.........................................|  |................................|
|.........................................|  |................................|
|.........................................|  |................................|
|.........................................|  |................................|
|-----------------------------------------------------------------------------|
