|-----------------------------------------------------------------------------|
|.............................................................................|
|.............................................................................|
|.............................................................................|
|.............................................................................|
|.............................................................................|
|-------------------------+------|.........|------+---------------------------|
|                         #      |.........|      #                           |
|-------------------------+----| |.........| |----+---------------------------|
|..............................| |.........| |................................|
|..............................| |.........| |................................|
|..............................| |.........| |................................|
|-----------+--------|.........| |.........| |.........|--------+-------------|
|           #        |.........| |.........| |.........|        #             |
|-----------+------| |.........| |.........| |.........| |------+-------------|
|..................| |.........| |.........| |.........| |....................|
|..................| |.........| |.........| |.........| |....................|
|..................| |.........| |.........| |.........| |....................|
|..................| |.........| |.........| |.........| |....................|
|..................| |.........+#+.........+#+.........| |....................|
|..................| |.........| |.........| |.........| |....................|
|..................| |.........| |.........| |.........| |....................|
|..................| |.........| |.........| |.........| |....................|
|..................| |.........| |.........| |.........| |....................|
|-----------------------------------------------------------------------------|
