|-----------------------------------------------------------------------------|
|...........................................|.................................|
|...........................................|.................................|
|...........................................|.................................|
|...........................................|.................................|
|...............................|-------------+-----------|...................|
|...............................+#|.....................| |...................|
|...............................|#|.....................| |...................|
|...............................|#|.....................| |...................|
|...............................|#+.....................| |...................|
|...............................| |.....|........|......| |...................|
|...............................| |.....|........|......| |...................|
|-------------------------------| |.....|........|......| |...................|
|...............................|-|.....|--------|......|-|-------------------|
|.................................|.....................|.....................|
|.................................|.....................|.....................|
|.................................|--------+--------+---|.....................|
|.........................................|# |................................|
|.........................................+# |................................|
|.........................................|  |................................|
|.........................................|  |................................|
|.........................................|  |................................|
|.........................................|  |................................|
|.........................................|  |................................|
|-----------------------------------------------------------------------------|
