|-----------------------------------------------------------------------------|
|................................|        |...................................|
|................................|        |...................................|
|................................+##    ##+...................................|
|................................| #    # |...................................|
|................................| #    # |...................................|
|................|-----------------+----+----------------|....................|
|................| |...................................| |....................|
|................| |...................................| |....................|
|................| |...................................| |....................|
|................| |...................................| |....................|
|----------------| |...................................| |--------------------|
|                  |...................................|                      |
|                  |...................................|                      |
|----------------| |...................................| |--------------------|
|................| |...................................| |....................|
|................| |...................................| |....................|
|................|-----------------+----+----------------|....................|
|................................| #    # |...................................|
|................................+##    ##+...................................|
|................................|        |...................................|
|................................|        |...................................|
|................................|        |...................................|
|................................|        |...................................|
|-----------------------------------------------------------------------------|
