|-----------------------------------------------------------------------------|
|                           |..........................|                      |
|                           |..........................| |------------------| |
|                           |..........................| |..................| |
|                           |..........................| |..................| |
|                           |..........................+#+..................| |
|                           |..........................| |..................| |
|                           |-----------+--------------| |..................| |
|                                       #                |..................| |
|                           |-----------+--------------| |..................| |
|                           |..........................| |------------------| |
|                           |..........................|                      |
|              #############+..........................|                      |
|  |-----------+--------|   |..........................|                      |
|  |....................|   |..........................|                      |
|  |....................|   |----------------------+---|                      |
|  |....................|                          #                          |
|  |....................|   |----------------------+---|                      |
|  |....................|   |..........................|                      |
|  |....................|   |..........................|                      |
|  |....................|   |..........................|                      |
|  |....................+###+..........................|                      |
|  |--------------------|   |..........................|                      |
|                           |..........................|                      |
|-----------------------------------------------------------------------------|
