|-----------------------------------------------------------------------------|
|................................|        |...................................|
|................................|        |...................................|
|................................|       #+...................................|
|................................|       #|...................................|
|................................|       #|...................................|
|................|-----------------------+---------------|....................|
|................| |...................................| |....................|
|................| |...................................| |....................|
|................| |...................................| |....................|
|................| |...................................| |....................|
|-------+--------| |...................................| |--------------------|
|       ###########+...................................|                      |
|                  |...................................+###############       |
|----------------| |...................................| |------------+-------|
|................| |...................................| |....................|
|................| |...................................| |....................|
|................|----------------------+----------------|....................|
|................................|      # |...................................|
|................................|      # |...................................|
|................................|      # |...................................|
|................................|      # |...................................|
|................................|      # |...................................|
|................................|      ##+...................................|
|-----------------------------------------------------------------------------|
