|-----------------------------------------------------------------------------|
|.............................................................................|
|.............................................................................|
|.............................................................................|
|.............................................................................|
|.............................................................................|
|--------------------------------|.........|------+---------------------------|
|                                |.........|      #                           |
|------------------------------| |.........| |----+---------------------------|
|..............................| |.........| |................................|
|..............................| |.........| |................................|
|..............................| |.........| |................................|
|-----------+--------|.........| |.........| |.........|----------------------|
|           #        |.........| |.........| |.........|#########             |
|-----------+------| |.........| |.........| |.........|#|------+-------------|
|..................| |.........| |.........| |.........|#|....................|
|..................| |.........| |.........| |.........|#|....................|
|..................| |.........| |.........| |.........|#|....................|
|..................| |.........| |.........| |.........|#|....................|
|..................+#+.........+#+.........+#+.........+#|....................|
|..................| |.........| |.........| |.........| |....................|
|..................| |.........| |.........| |.........| |....................|
|..................| |.........| |.........| |.........| |....................|
|..................| |.........| |.........| |.........| |....................|
|-----------------------------------------------------------------------------|
