|-----------------------------------------------------------------------------|
|                     |---------------------------------------|  |----------| |
|   |---------------| |.......................................|  |..........| |
|   |...............| |.......................................|  |..........| |
|   |...............| |----+-------------------------|........|  |..........| |
|   |...............|      #      |-------------|    |........+##+..........| |
|   |...............|      #      |.............|    |........|  |..........| |
|   |...............|------+------|.............|    |........|  |..........| |
|   |...........................................|    |........|  |..........| |
|   |...........................................|    |........|  |..........| |
|   |...........................................|    |........|  |..........| |
|   |----------|.......|------------------------|    |--------|  |..........| |
|              |.......|                                         |..........| |
|   |----------|.......|---|  |-----------|  |-------------------|..........| |
|   |......................|  |...........|  |..............................| |
|   |......................|  |...........+##+..............................| |
|   |......................+##+...........|  |..............................| |
|   |......................|  |...........|  |------+-----------------------| |
|   |......................|  |...........|         #       |--------------|  |
|   |......................|  |...........|---------+-----| |..............|  |
|   |......................|  |...........................| |..............|  |
|   |......................| #+...........................|#+..............|  |
|   |----------------------| #|---------------------------|#|..............|  |
|                            ###############################|--------------|  |
|-----------------------------------------------------------------------------|
