|-----------------------------------------------------------------------------|
|...........................................|.................................|
|...........................................+.................................|
|...........................................|.................................|
|...........................................|.................................|
|...............................|-------------------------|...................|
|...............................| |.....................| |...................|
|...............................| |.....................| |...................|
|...............................+#+.....................+#+...................|
|...............................| |.....................| |...................|
|...............................| |.....|........|......| |...................|
|...............................| |.....|........|......| |...................|
|-----------------+-------------| |.....|........|......| |...................|
|...............................|-|.....|--------|......|-|-+-----------------|
|.................................|.....................|.....................|
|.................................|.....................|.....................|
|.................................|--------------+------|.....................|
|.........................................|  |................................|
|.........................................|  |................................|
|.........................................|  |................................|
|.........................................|  |................................|
|.........................................+##+................................|
|.........................................|  |................................|
|.........................................|  |................................|
|-----------------------------------------------------------------------------|
