|-----------------------------------------------------------------------------|
|                           |..........................|                      |
|                           |..........................| |------------------| |
|              #############+..........................| |..................| |
|              #            |..........................| |..................| |
|              #            |..........................| |..................| |
|              #            |..........................| |..................| |
|              #            |--------------------------| |..................| |
|              #                                    #####+..................| |
|              #            |-----------------------+--| |..................| |
|              #            |..........................| |-----------+------| |
|              #            |..........................|             #        |
|              #            |..........................|             #        |
|  |-----------+--------|   |..........................|             #        |
|  |....................+###+..........................|             #        |
|  |....................|   |--------------------------|             #        |
|  |....................|                                            #        |
|  |....................|   |--------------------------|             #        |
|  |....................|   |..........................|             #        |
|  |....................|   |..........................|             #        |
|  |....................|   |..........................|             #        |
|  |....................|   |..........................+##############        |
|  |--------------------|   |..........................|                      |
|                           |..........................|                      |
|-----------------------------------------------------------------------------|
