|-----------------------------------------------------------------------------|
|..............................| |............................................|
|..............................| |............................................|
|..............................| |............................................|
|..............................+#|............................................|
|..............................|#|............................................|
|------------------------------|#|.........|------+---------------------------|
|                               #|.........|      #                           |
|------------------------------|#|.........|------+---------------------------|
|..............................+#|............................................|
|..............................| |............................................|
|..............................| |............................................|
|-----------+--------|.........| |.........|-|.........|----------------------|
|           #        |.........| |.........| |.........+#########             |
|-----------+------| |.........| |.........| |.........| |------+-------------|
|..................| |.........| |.........| |.........| |....................|
|..................| |.........| |.........| |.........| |....................|
|..................| |.........+#+.........| |.........| |....................|
|..................| |.........| |.........| |.........| |....................|
|..................| |.........| |.........| |.........| |....................|
|..................| |.........| |.........| |.........| |....................|
|..................| |.........| |.........| |.........| |....................|
|..................| |.........| |.........| |.........| |....................|
|..................| |.........| |.........| |.........| |....................|
|-----------------------------------------------------------------------------|
