|-----------------------------------------------------------------------------|
|                           |..........................|###                ###|
|                           |..........................|#|+----------------+|#|
| ##########################+..........................|#|..................|#|
| #                         |..........................|#|..................|#|
| #                         |..........................|#|..................|#|
| #                         |..........................|#|..................|#|
| #                         |------------------------+-|#|..................|#|
| #                    ###############################  #|..................|#|
| #                    #    |--------------------------|#|..................|#|
| #                    #    |..........................|#|------------------|#|
| #                    #    |..........................|#                    #|
| #                    #####+..........................+#                    #|
| #|--------------------|   |..........................|                     #|
| #|....................|   |..........................|                     #|
| #|....................|   |--------------------------|                     #|
| #|....................+#####################################################|
| #|....................|   |--------------------------|                      |
| #|....................|   |..........................|                      |
| #|....................|   |..........................|                      |
| #|....................|   |..........................|                      |
| #|....................|   |..........................|                      |
| #|--------------------|   |..........................|                      |
| ##########################+..........................|                      |
|-----------------------------------------------------------------------------|
