    |--------|       |--------------|                                          
    |........|       |..............|                                          
    |........|-------|..............|                                          
    |...............................|------|                                   
    |......................................|                                   
    |......................................+#####                              
    |...............................|------|    #                              
    |...............................|           #                              
    |...............................|           #                              
    |------------+------------------|           #                              
                 #                              #                              
                 #                              #                              
                 #                              #                              
                 #                              #         |-------------------|
                 #                              #       |-|...................|
                 #######################################+.....................|
                                                        |-|...................|
                                                          |...................|
                                                        |-|...................|
                                                        |.....................|
                                                        |---------------------|
                                                                               
                                                                               
                                                                               
                                                                               
